##################
#!########## !####
##  ####       ###
####   !       ###
##             ###
##     EFGH     ##
#  !   IABJ     ##
####   KCDL     ##
#### ! MNOP!   ###
##!            ###
##            ####
##    ##! ### ####
##  #         ####
##     ###########
##  !    #########
######       #####
#####!       !####
##################
